take away : prendre, retirer, enlever
lift up : soulever
vanish : disparaître
rambler : randonneur
skull : crâne
skeleton : squelette
breakthrough : découverte capitale, avancée
enquiry : enquête, investigation
frantic : frénétique, effréné
baffle : dérouter, déconcerter
drawn : tiré
statement : déclaration
prosecutor : procureur
underway : en cours
carry out : effectuer, réaliser, mener à bien
investigator : enquêteur
rule out : écarter
abduction : enlèvement, kidnapping
disappearance : disparition
wander off : s'éloigner
spark : déclencher
swindle : escroquer
monk : moine
give up : abandonner
bring up : élever (des enfants)
media outlet : média, organe de presse
walk down : descendre
deny : nier
boarding : internat, pensionnat
countryside : campagne
yield : produire
casual : détendu, décontracté
uncaring : insensible
nearby : dans les environs, pas loin
thrilled : surexcité
prompting : incitation, encouragement
bounden : obligatoire
the elderly : les personnes agées
come over : passer, faire un saut
bother to : faire un effort
princeling : petit prince
lorry : camion
harass : harceler
angry : en colère
sitting duck : personne facilement attaquable
advertisement : publicité, annonce
turn up : venir, se pointer
barge in : faire irruption
beg : supplier
breach : violation, infraction
upon : dès que
exhausting : épuisant, exténuant
fearful : craintif, inquiet, peureux
stakes : enjeux
mayor : maire
outcome : résultat
blow : coup, choc
ballot : scrutin, vote
acknowledge : admettre, reconnaître
vow : voeu
ahead : devant
horn : klaxon
chairman : président
gather : regrouper, réunir
drape : poser, accrocher
incumbent : actuel, en place, en fonction
ruling : dirigeant, au pouvoir
fall apart : tomber en morceaux, se désagréger
in the wake : à la suite de
rattle : bruit de féraille
plunge into : plonger dans
strike : frappe, attaque
damage : dégâts
knock out : assomer, mettre ko
screeching : crissement, cri strident
blast : explosion
blow out : souffler, éteindre
aim : viser
lift : ascenseur
whirring : qui ronronne, bruissement
throughout : tout au long de, à travers, d'un bout à l'autre
shatter : voler en éclats
scramble : se dépêcher, se précipiter
shiver : frissonner, trembler
abortion : avortement
mix up : confondre
stork : cigogne
magnet : aimant, attirer
rewilding : réensauvagement, remise à l'état sauvage
rewind : rembobiner
wade : patauger
mud : boue
scenery : paysage, décor
oak : chêne
trodden : fréquenté, emprunté
puddle : flaque d'eau
scrub : broussaile
tangled : emmêlé, enchevêtré
high up : haut placé
glide : planer
nest : nid
clatter : fracas, bruit fort
headquarters : siège social, quartier général
climb : monter, grimper
bonding : se rapprocher de [qqn], nouer des liens
grow : grandir, pousser, se développer
breed : se reproduire, se multiplier
breeding : élevage
feed : nourir, donner à manger
tracker : traqueur, pisteur
journey : voyage
hazard : danger
rebound : reprise, remontée
thrive : bien se porter, grandir, se développer
forage : chercher de la nourriture
alongside : à côté
loss : perte, détérioration
drained : vidé, épuisé, asséché, drainé
brambles : ronces
deer : cerf, biche
thorny : épineux
thicket : fourré
livestock : bétail, cheptel
channel : canal, sillon
gregarious : sociable
soar : s'envoler, monter en flèche
carry : porter
sighting : observation, être aperçu
sight : vue
bring over : apporter, emmener
fledgling : oisillon, débutant
overall : global, dans l'ensemble
zip : compresser
back and forth : aller et venir, faire la navette
figure out : comprendre, résoudre
weak : faible
updraft : courant d'air ascendant
stretch : portion de route
stretch : s'étirer
vessel : vaisseau, bateau, navire
flock : troupeau
swell : gonfler, enfler, augmenter
vulture : vautour
owl : hibou, chouette
insulating : isolant, insonorisant
hearty : jovial, chaleureux
feast : festin, banquet
waste : gaspiller
landfill : décharge
grim : sinistre, sombre
hang out : traîner, glander
trend : tendance
eventually : finalement
keen : fan, passionné
bug : insecte
worm : ver de terre
rot : pourrir
log : rondin, bûche
mown : tondu
dry stone : pierre sèche
tumble : tomber, chuter
toddler : bambin, tout-petit
stun : assomer, étourdir
unlikely : peu probable
branded : marqué, stigmatisé
flumbling : maladroit
sneak out : sortir en douce
testimony : témoignage
a tad : un petit peu, un chouïa
clueless : incapable, nul
saucy : osé, coquin
stark : dur, rude, saisissant
harsh : sévère, dur
stab : poignarder
nonce : pédophile
withdrawn : renfermé, introverti
curl : s'enrouler
sobbing : sanglots, pleurs
meltdown : effondrement, défaillance
betray : trahir
fumble : fouiller
whip : sortir, dégainer
frenzy : frénésie, folie
allegation : accusation
agonize : se tourmenter, se tracasser
unnerving : troublant, perturbant
dismiss : licencier, renvoyer, écarter, rejeter
scant : peu de, rare
headteacher : directeur
genuinely : sincèrement
crumble : s'effondrer, s'émietter
plight : situation désespérée
crumb : miette
unearth : déterrer, exhumer
gossip : ragôts, commérages
senselessly : sans raison
sacking : renvoi, licenciement 
frightfully : affreusement, horriblement
fuel : carburant, combustible
swap : échanger
countless : d'innombrables
guilty : coupable
wrecked : détruit, démoli
although : bien que
intercourse : relations sexuelles
pander to : céder aux caprices de
wisely : prudemment, sagement
rampant : effrené, galopant
vouch : se porter garant
voucher : bon d'échange, reçu, quittance
unhinged : déséquilibré, dérangé
bullying : agression
horrendous : terrible, horrible
lad : garçon, gars
shoulder : endosser, assumer
delusional : délirant
reminisce : évoquer des souvenirs
betrayal : trahison
lap dance : danse érotique
shortage : manque, pénurie
admission : aveu, confession, admission
ingrained : enraciné, inébranlable, tenace
courtesy : courtoisie
void : nul, dénué de
weep : pleurer
staggering : impressionnant, sidérant, ahurissant
bill : facture
council : conseil, conseil municipal
fence : barrière, clôture
have a row : se disputer
carer : aidant, auxiliaire de vie
swearing : jurer, gros mots
hefty : lourd, gros
contempt of court : outrage à magistrat
storm : tempête, orage
encroach : empiéter
appealing : attirant, attrayant
tear out : arracher
concrete : béton
bully : brute
briton : britannique
bank holiday : jour férié
head out : partir
thunder : tonnerre
hail : grêle
leisure : loisir, temps libre
swollen : enflé, gonflé
pass out : tomber dans les pommes
disruption : perturbation, dérangement
trapped : piégé
clog up : boucher, obstruer
staycation : vacances près de chez soi
amid : au milieu de
heating : chauffage
cripple : handicaper, paralyser
shareholder : actionnaire
oven : four
unconscionable : déraisonnable, inadmissible
capped : plafonné, bloqué
fortunate : chanceux
shrug : hausser les épaules
investigation : enquête, étude
lass : fille, jeune fille, meuf
convicted : condamné, inculpé
bravery : courage, vaillance, bravoure
abridging : abréger
decay : décomposition
unveiled : dévoilé, découvert
beneath : sous, au-dessous de
glitter : briller, scintiller
accomodate : loger, héberger
accomodation : hébergement
ash : cendre
inter : enterrer
formal : officiel, de cérémonie
unfurl : se déployer
embrace : étreindre, accolade
backdrop : décor, arrière-plan
roadside : bord de la route
upside down : à l'envers
be rubbish at : être nul à
roundabout : rond-point
oversight : oubli, erreur
sink : couler
graft : travailler dur
take over : prendre le relai, prendre la relève
aim : but, objectif
ladder : échelle
establishment : fondation
cold blooded : à sang froid
thief : voleur
crook : escroc
theft : vol
tackle : s'attaquer à
on your back foot : sur la défensive
bemoan : se lamenter sur, se plaindre de
manufacturer : fabricant industriel
insurable : assurable
welsh : gallois
carriageway : chaussée, voies
estate : domaine, propriété
contempt : mépris, dédain
number plate : plaque d'immatriculation
upset : contrarié
dare : oser faire
flurry of : déluge de
issue : remettre, distribuer, délivrer
stir up : susciter
hatred : haine
prominent : célèbre, connu
unleash : déchaîner, déclencher
belief : croyance
deem : juger, estimer, considérer
threshold : seuil
claim : affirmation, déclaration
widespread : étendu, répandu
backlash : réaction violente, retour de bâton
offence : infraction
commit : commettre
astonishing : étonnant, stupéfiant
spokesman : porte-parole
rally : rassemblement
stage : scène, mettre en scène
stifle : réprimer
rate : taux
asset : actif, capital
assessment : évaluation, estimation
among : parmi
start over : recommencer
loan : emprunt, prêt
ease : facilité, aisance
bread : pain
pain : douleur
workaround : solution de rechange
shake up : agiter, secouer
give up : abandonner
astonish : étonner, stupéfier
crackdown : répression, mesures répressives
overtime : heures supplémentaires
overwork : surmenage
unemployment : chômage
welfare : bien-être
birthrate : taux de natalité
trainee : stagiaire, apprenti
gender : genre, sexe
flee : fuir
concern : souci, inquiétude
workforce : main-d'oeuvre, employés, collaborateurs
income : revenu, bénéfices
tip : pourboire
growth : croissance, développement
afterword : épilogue
backside : fesses, postérieur
rub : frotter
rob : cambrioler, voler
overalls : bleu de travail, combinaison
facility : établissement, complexe (sportif / hôtelier)
conservative : prudent, conservateur
speak up : parler plus fort
sustainable : viable, durable
affordable : abordable, pas trop cher
shift : déplacer, décaler
shortage : manque, pénurie
spark : étincelle, éclair
deal with : faire face, gérer
handle : s'occuper de, se charger de
grade : note
welsh : partir sans payer, ne pas tenir un promesse
villager : villageois
fury : fureur, colère
fork out : débourser, claquer
fork : fourchette
knife : couteau
strangle : étrangler
evil : mal, malfaisant
officer : policier
conviction : condamnation
neglect : négligence, manque de soins
mistreatment : mauvais traitement
bruise : bleu, hématome
squeeze through : se frayer un chemin
pane : carreau
frame : cadre, encadrement
wander : flâner, déambuler, errer, vagabonder
cot : lit de camp
belt : ceinture
spare : épargner, économiser
to be spared jail : éviter la prison
look after : s'occuper de
despite : malgré
comatose : comateux
distress : détresse, désarroi
shout : criter, hurler
damp : humide
draught : courant d'air
prosecution : poursuite judiciaire
turn on : s'en prendre à
cope : surmonter
headbutt : coup de tête
lash out : s'en prendre à qqn
sudden : soudain
overwhelmed : accablé, submergé
appalling : épouvantable, effroyable, consternant
deadbeat : bon à rien
wickedness : méchanceté, cruauté
sorrow : chagrin, peine
low : bas, basse
traveller : gitan, manouche, romanichel
digger : pelleteuse
seemingly : apparement
settle : s'installer
covenant : engagement, contrat
afford : se payer, avoir les moyens d'acheter
redundancy : licenciement 
sink : couler
scheme : projet
unravel : résoudre
bleak : lugubre, morne
spell : écrire, épeler
doom : mort
diminishing : qui diminue
beware : faire attention à
collar : col
trial : procès
lay : poser, mettre
straight : droit
go straight on : continuer tout droit
ridden : cribblé de
boiler : chaudière, chauffe-eau
flood : inondation
leak : fuite
faulty : défectueux
withdraw : se retirer
relentless : incessant, continuel
breaststroke : brasse
bullshit : conneries
downward : vers le bas
numb : engourdi, insensible
unveiled : dévoiler
tribute : hommage
chest : poitrine
tough : dur, rude, solide
hilarious : hilarant, extrêmement drôle
brash : culotté, effronté, imprudent
fizzle out : tomber à l'eau
ably : avec compétence
ordeal : épreuve, supplice
belly : ventre
council : conseil municipal
brand : marque
estate : domaine, propriété
rife with : plein de, rempli de
rusty : rouillé
slum : quartier pauvre, bidonville
labour : travailliste
cramped : exigu, à l'étroit
dub : surnommer
allege : prétendre
bully : tyranniser, persécuter
disgraceful : honteux, scandaleux
tenant : locataire
subhuman : inhumain
household : famille, foyer, ménage
arrears : arriéré, défaut de paiement